###
#.#
##$####
#     #
# **  ####
# * ***  #
##*  * *  #
# * ## * ##
# *    * #
#  ** *  #
#   @  ###
########
