#######
##     ##
#  ###  #
## # + # #
#  #$* # #
# ## *   #
# #  *  ##
# #  * ##
# #  *####
#  # *   #
## # #  *#
# #   # #
#  ###  #
##     ##
#######
