######
#    #
# ## ###
#  $   #
#$.$ $ #
#+.##$##
#..   #
#######
