   ####
####  ####
#        #
#.$***** #
#   @# * #
###### * ##
     # *  #
     #    #
     #   ##
     #####
