 #####
 # + #
 #$.$#
## * #
#  * ##
#  *  #
#  *  #
###  ##
  ####
