9 10
  ####
  #  #####
### .#   #
#@  $    #
# ##*#####
#   $  #
### .  #
  #  ###
  ####
