#######
#.XX@X#
#X#.#X#
#XXX$X#
#.$$X##
#XX####
####XXX
