#######
#.###.#
# #  .#
# $$ @#
#  $  #
#  #  #
#  ####
#######
